00000000000000000000
11111111111111111110
00000000000000000000
01111111111111111111
00000001111111111111
11111100000000111111
11110001111100011111
11100111212111001111
11100111121111001111
11100111212111001111
11110001111100011111
11111100000001111111
11111111111000000000
